    #####             
    #   #             
    #$  #             
  ###  $###           
  #  $  $ #           
### # ### #     ######
#   # ### #######  OO#
# $ $             OO#
##### #### #@####  OO#
    #      ###  ######
    ########          